  #   #
 # # ##
  # # #
  # # #
 #  # #
#  #  #
 @# # #
   # ##
