  # # #
 # P P
# # # #
 # # #
# @ # #
 # # #
# # # #
 # # #
