 @ # #
# # # #
 # P #
# # # #
 # # #

# # # P
 # # #
