 #   #
# ### #
 #   #
 #   #
# ### #
 #   #
 # # #
### #@#
