 # # #
##P ###
 # # #
 ## ##
# #@# #
 # # #
### P##
 # # #
