@ #  ##
 # ## #
  #   #
 #  ###
# #  #
 # #  #
  #  #
 #####
