#   #
 # # #
  # @ #
 #   #
#   #
 # #
# #
 #
