# # # #
## # ##
#     #
### ###
  # #
  # #
 #   #
######@
